.............###...#####..#...#...###...####...#####
............#...#....#....#...#..#...#..#...#....#..
............#........#....#...#..#...#..#...#....#..
.............###.....#....#...#..#####..####.....#..
................#....#....#...#..#...#..#...#....#..
............#...#....#....#...#..#...#..#...#....#..
.............###.....#.....###...#...#..#...#....#..
